#####################################################################################################
#B          ###                                                                                     #
#### ######     ################################################################################### #
#      A   #####                                                                                    #
########## ##### ##                                                                                 #
#                 #                                                                                 #
#                 #                                                                                 #
#                 #                                                                                 #
#                                                                                                   #
#####################################################################################################