#########################
#           ###         #
#### ######     ####### #
#      A...#####        #
##########.##### ##     #
#         .       #     #
#         .       #     #
#         .       #     #
#         .             #
#         .             #
#         .             #
#         .             #
#         .             #
#         .             #
#         .             #
#         .             #
#         .             #
#         .             #
#         .             #
#         .             #
#         .             #
#         .             #
#         .             #
#         .             #
#         .             #
#         .             #
#         .             #
#         .             #
#         .             #
#         .             #
#         .             #
#         .             #
#         .             #
#         .             #
#         .             #
#         .             #
#         .             #
#         .             #
#         .             #
#         .             #
#         .             #
#         .             #
#         .             #
#         .             #
#         .             #
#         .             #
#         .             #
#         .             #
#         .             #
#         .             #
#         .             #
#         .             #
#         .             #
#         .             #
#         .             #
#         .             #
#         .             #
#         .             #
#         .             #
#         .             #
#         .             #
#         .             #
#         .             #
#         .             #
#         .             #
#         .             #
#         .             #
#         .             #
#         .             #
#         .             #
#         .             #
#         .             #
#         .             #
#         .             #
#         .             #
#         .             #
#         .             #
#         .             #
#         .             #
#         .             #
#         .             #
#         .             #
#         .             #
#         .             #
#         .             #
#         .             #
#         .             #
#         .             #
#         .             #
#         .             #
#         .             #
#         .             #
#         .             #
#         .             #
#         .             #
#         ..B           #
#                       #
#                       #
#########################