###################################################################################################
#B...       ###                                                                                   #
####.######     ################################################################################# #
#   ...A   #####                                                                                  #
########## ##### ##                                                                               #
#                 #                                                                               #
#                 #                                                                               #
#                 #                                                                               #
#                                                                                                 #
###################################################################################################