####################################################################################################
#A                                                                                                 #
#.                                                                                                 #
#.                                                                                                 #
#.                                                                                                 #
#.                                                                                                 #
#.                                                                                                 #
#.                                                                                                 #
#.                                                                                                 #
#.                                                                                                 #
#.                                                                                                 #
#.                                                                                                 #
#.                                                                                                 #
#.                                                                                                 #
#.                                                                                                 #
#.                                                                                                 #
#.                                                                                                 #
#.                                                                                                 #
#.                                                                                                 #
#.                                                                                                 #
#.                                                                                                 #
#.                                                                                                 #
#.                                                                                                 #
#.                                                                                                 #
#.                                                                                                 #
#.                                                                                                 #
#.                                                                                                 #
#.                                                                                                 #
#.                                                                                                 #
#.                                                                                                 #
#.                                                                                                 #
#.                                                                                                 #
#.                                                                                                 #
#.                                                                                                 #
#.                                                                                                 #
#.                                                                                                 #
#.                                                                                                 #
#.                                                                                                 #
#.                                                                                                 #
#.                                                                                                 #
#.                                                                                                 #
#.                                                                                                 #
#.                                                                                                 #
#.                                                                                                 #
#.                                                                                                 #
#.                                                                                                 #
#.                                                                                                 #
#.                                                                                                 #
#.                                                                                                 #
#.                                                                                                 #
#.                                                                                                 #
#.                                                                                                 #
#.                                                                                                 #
#.                                                                                                 #
#.                                                                                                 #
#.                                                                                                 #
#.                                                                                                 #
#.                                                                                                 #
#.                                                                                                 #
#.                                                                                                 #
#.                                                                                                 #
#.                                                                                                 #
#.                                                                                                 #
#.                                                                                                 #
#.                                                                                                 #
#.                                                                                                 #
#.                                                                                                 #
#.                                                                                                 #
#.                                                                                                 #
#.                                                                                                 #
#.                                                                                                 #
#.                                                                                                 #
#.                                                                                                 #
#.                                                                                                 #
#.                                                                                                 #
#.                                                                                                 #
#.                                                                                                 #
#.                                                                                                 #
#.                                                                                                 #
#.                                                                                                 #
#.                                                                                                 #
#.                                                                                                 #
#.                                                                                                 #
#.                                                                                                 #
#.                                                                                                 #
#.                                                                                                 #
#.                                                                                                 #
#.                                                                                                 #
#.                                                                                                 #
#.                                                                                                 #
#.                                                                                                 #
#.                                                                                                 #
#.                                                                                                 #
#.                                                                                                 #
#.                                                                                                 #
#.                                                                                                 #
#.                                                                                                 #
#.                                                                                                 #
#.................................................................................................B#
####################################################################################################