
      #######
  ### #B #  #                 ####
  # ###  #  #                 #  #
  #     ## ####################  #
  #         #                  A #
 ##  #####  # ################   #
 #   #   # ## #              #   #
 #   #   #    #              #####
 #   #   #    #
 #####   ######