###################################################################################################
#B          ###                                                                                   #
#### ######     ################################################################################# #
#      A   #####                                                                                  #
########## ##### ##                                                                               #
#                 #                                                                               #
#                 #                                                                               #
#                 #                                                                               #
#                                                                                                 #
###################################################################################################