####################################################################################################
#B...       ###                                                                                    #
####.######     ################################################################################## #
#   ...A   #####                                                                                   #
########## ##### ##                                                                                #
#                 #                                                                                #
#                 #                                                                                #
#                 #                                                                                #
#                                                                                                  #
####################################################################################################