###########
#.... #   #
#. #.     #
#A #..... #
#  #   #. #
#     ##.###
####### .  #
#     ...  #
#     .### #
#     .    #
#     ..B  #
############