######
#A   #
#
#    #
#   B#
######