###########
#     #   #
#  #      #
#A #      #
#  #   #  #
#     ## ###
#######    #
#          #
#      ### #
#          #
#       B  #
############