####################################################################################################
#           ###                                                                                    #
#### ######     ################################################################################## #
#      A...#####                                                                                   #
##########.##### ##                                                                                #
#         .       #                                                                                #
#         .       #                                                                                #
#         .       #                                                                                #
#         .                                                                                        #
#         .                                                                                        #
#         .                                                                                        #
#         .                                                                                        #
#         .                                                                                        #
#         .                                                                                        #
#         .                                                                                        #
#         .                                                                                        #
#         .                                                                                        #
#         .                                                                                        #
#         .                                                                                        #
#         .                                                                                        #
#         .                                                                                        #
#         .                                                                                        #
#         .                                                                                        #
#         .                                                                                        #
#         .                                                                                        #
#         .                                                                                        #
#         .                                                                                        #
#         .                                                                                        #
#         .                                                                                        #
#         .                                                                                        #
#         .                                                                                        #
#         .                                                                                        #
#         .                                                                                        #
#         .                                                                                        #
#         .                                                                                        #
#         .                                                                                        #
#         .                                                                                        #
#         .                                                                                        #
#         .                                                                                        #
#         .                                                                                        #
#         .                                                                                        #
#         .                                                                                        #
#         .                                                                                        #
#         .                                                                                        #
#         .                                                                                        #
#         .                                                                                        #
#         .                                                                                        #
#         .                                                                                        #
#         .                                                                                        #
#         .                                                                                        #
#         .                                                                                        #
#         .                                                                                        #
#         .                                                                                        #
#         .                                                                                        #
#         .                                                                                        #
#         .                                                                                        #
#         .                                                                                        #
#         .                                                                                        #
#         .                                                                                        #
#         .                                                                                        #
#         .                                                                                        #
#         .                                                                                        #
#         .                                                                                        #
#         .                                                                                        #
#         .                                                                                        #
#         .                                                                                        #
#         .                                                                                        #
#         .                                                                                        #
#         .                                                                                        #
#         .                                                                                        #
#         .                                                                                        #
#         .                                                                                        #
#         .                                                                                        #
#         .                                                                                        #
#         .                                                                                        #
#         .                                                                                        #
#         .                                                                                        #
#         .                                                                                        #
#         .                                                                                        #
#         .                                                                                        #
#         .                                                                                        #
#         .                                                                                        #
#         .                                                                                        #
#         .                                                                                        #
#         .                                                                                        #
#         .                                                                                        #
#         .                                                                                        #
#         .                                                                                        #
#         .                                                                                        #
#         .                                                                                        #
#         .                                                                                        #
#         .                                                                                        #
#         .                                                                                        #
#         .                                                                                        #
#         .                                                                                        #
#         .                                                                                        #
#         ....................................................................B                    #
#                                                                                                  #
#                                                                                                  #
####################################################################################################